_ H H H H H H H H H _
_ H N N N N N N N H _
_ H N H H H H H N H _
_ H N H _ E _ H N H _
_ H N H H H H H N H _
_ H N N N E N N N H _
_ H H H H H H H H H _
_ _ _ _ _ _ _ _ _ _ _