_ _ N N N N N N N _ _
_ _ N H H H H H N _ _
_ _ N H H H H H N _ _
_ _ N H H H H H N _ _
_ _ N N N N N N N _ _
_ _ _ _ _ _ _ _ _ _ _